xxxxxxxxxx
xMooo    x
x      o x
x  o     x
x        x
x   o    x
x       ox
xo       x
x    o   x
xxxxxxxxxx